EDGES: [1,2] [1,3] [1,5] [5,4] [5,0] [0,8] [8,10] [8,9] [9,10] [6,7] [7,8] [1,7]
CORE_EDGES: [1,a] [4,b] [0,d] [6,c] [9,e]

AS 0 1-3 a
AS 1 4-5 b
AS 2 0-0 d
AS 3 6-7 c
AS 4 8-10 e

MAP 10 16
-   -   -   -   -   -   4   b   -   -
-   -   -   -   -   -   -   -   -   -
-   a   -   -   -   -   5   -   -   -
2   -   3   -   -   -   -   -   -   -
-   1   -   -   -   -   -   -   -   -
-   -   -   -   -   -   -   d   -   -
-   -   -   -   -   -   0   -   -   -
-   -   -   -   -   -   -   -   -   -
-   7   -   -   -   -   -   -   -   -
6   -   -   -   -   -   -   -   -   -
c   -   -   -   -   -   -   -   -   -
-   -   -   -   -   -   -   -   -   -
-   -   -   -   -   -   -   -   -   -
-   -   -   -   8   -   -   -   -   -
-   -   -   9   -   10  -   -   -   -
-   -   -   e   -   -   -   -   -   -
ENDMAP

PLAYER 0 CPU,a Server,2 SQLInjection,1 PingOfDeath,2
PLAYER 1 CPU,e Server,9 Database,7 Firewall,8 DOS,7 DOS,7 PingOfDeath,7 DOS,7 DOS,7

AI 1